  #######################################################
  #         ###                           #             #
  #         ###          #                #             #
  ######                 ##               #      #      #
  #         ########     ###        ###   ####  ###     #
  #                      #          #            #      #
  #  ####                #     ######                   #
  #     #      #####     #     ######       #           #
  #     #      ##        #     ######       #    ##     #
  #            ##                           #    ##     #
  ######    #####                      #    # ###########
  #             #       #####          #                #
  #             #       #####    #######                #
  #     ####            #####          #   ####   #     #
  #        #        #                  #   #      ##### #
  #        #        #                      #            #
  #  ###   #        ######       ######    #            #
  #  ###        #        #       ######         #   #   #
  #  ###        #        ####    #    #         #   #   #
  #  ###        #    #   ####    #    ######    #   #   #
  #        ######    #                          #       #
  #                  #                          #       #
  #######################################################